[Shop: Bar_(location)]

Abar,pub, orinnis a place wherealcoholis sold. Other drinks and foods may also be sold. On theworld mapthey are identified by the beer glassicon.

List of bars[edit|edit source]

Shop | Location | Members | Map | Leagueregion

Atlazora's Rest | Outer Fortis | 1 | Maplink | Varlamore✓

The Asp & Snake Bar | Pollnivneach | 1 | Maplink | Desert✓

The Big Heist Lodge | Bandit Camp | 1 | Maplink | Desert✓

Blue Moon Inn | Varrock | 0 | Maplink | Misthalin✓

Blurberry Bar | Grand Tree | 1 | Maplink | Kandarin✓

Blurberry Bar | Gnome Stronghold | 1 | Maplink | Kandarin✓

The Cloak and Stagger | Shayzien | 1 | Maplink | Kourend✓

The Crypt | Darkmeyer | 1 | Maplink | Morytania✓

Dancing Donkey Inn | Varrock | 0 | Maplink | Misthalin✓

Dead Man's Chest | Brimhaven | 1 | Maplink | Karamja✓

The Deeper Lode | Lovakengj | 1 | Maplink | Kourend✓

Dragon Inn | Yanille | 1 | Maplink | Kandarin✓

The Esoterican Arms | Miscellania and Etceteria Dungeon | 1 | Maplink | Fremennik✓

Fight Arena Bar | Fight Arena | 1 | Maplink | Kandarin✓

The Flaming Arrow | Civitas illa Fortis | 1 | Maplink | Varlamore✓

Flying Horse Inn | Ardougne | 1 | Maplink | Kandarin✓

Forester's Arms | Seers' Village | 1 | Maplink | Kandarin✓

The Golden Field | Hosidius | 1 | Maplink | Kourend✓

The Green Ghost | Port Phasmatys | 1 | Maplink | Morytania✓

Hair of the Dog | Canifis | 1 | Maplink | Morytania✓

Harpoon Joe's House of 'Rum' | Mos Le'Harmless | 1 | Maplink | Morytania✓

Hefin Inn | Prifddinas | 1 | Maplink | Tirannwn✓

Jolly Boar Inn | Varrock | 0 | Maplink | Misthalin✓

Karamja Wines, Spirits, and Beers | Karamja | 0 | Maplink | Karamja✓

King's Axe Inn | Keldagrim | 1 | Maplink | Fremennik✓

Laughing Miner Pub | Keldagrim | 1 | Maplink | Fremennik✓

The Long Hall | Barbarian Village | 0 | Maplink | Misthalin✓

The Legless Faun | Port Piscarilius | 1 | Maplink | Kourend✓

The Lost Pickaxe | Cam Torum | 1 | Maplink | Varlamore✓

The Old Nite | Ferox Enclave | 0 | Maplink | Wilderness✓

The Other Inn | Mos Le'Harmless | 1 | Maplink | Morytania✓

Paramaya Inn | Shilo Village | 1 | Maplink | Karamja✓

Falador Party Room | Falador | 0 | Maplink | Asgarnia✓

Rat & Bat | Slepe | 1 | Maplink | Morytania✓

Ratpit bar (Keldagrim) | UnderKeldagrim | 1 | Maplink | N/A

Ratpit bar (Port Sarim) | UnderPort Sarim | 1 | Maplink | N/A

Ratpit bar (Varrock) | UnderVarrock | 1 | Maplink | N/A

Rellekka Longhall Bar | Rellekka | 1 | Maplink | Fremennik✓

Rising Sun Inn | Falador | 0 | Maplink | Asgarnia✓

Rusty Anchor Inn | Port Sarim | 0 | Maplink | Asgarnia✓

The Sheared Ram | Lumbridge | 0 | Maplink | Misthalin✓

Skull in a Chest Inn | Meiyerditch | 1 | Maplink | Morytania✓

Stick Your Ore Inn | Mistrock | 1 | Maplink | Varlamore✓

Sunlight's Sanctum | Aldarin | 1 | Maplink | Varlamore✓

The Toad and Chicken | Burthorpe | 1 | Maplink | Asgarnia✓

The Toad and Chicken | Burthorpe Games Room | 1 | Maplink | Asgarnia✓

The WarrensPub | UnderPort Piscarilius | 1 | Show map | Kourend✓

White Wolf TunnelPub | UnderWhite Wolf Mountain | 1 | Show map | Kandarin✓Asgarnia✓

See also[edit|edit source]

Alfred Grimhand's BarcrawlBeer

A list of some quests that have a step in a bar:

Recipe for Disaster- Rising Sun Tavern, FaladorFamily Crest- Jolly Boar Inn, along the border of the Wilderness, north of VarrockZogre Flesh Eaters,Tower of Life- Dragon Inn, YanilleTemple of Ikov- Flying Horse Inn, East ArdougneGoblin Diplomacy- Port Sarim BarVampyre Slayer,Pirate's Treasure,Shield of Arrav- Blue Moon Inn, south-east VarrockDeath Plateau- The Toad and Chicken, Burthorpe

v•t•eBars, pubs, inns, and taverns

Free-to-play | Blue MoonDancing DonkeyFalador Party RoomJolly BoarKaramja Wines, Spirits, and BeersLong HallNutcrackerOld NiteRising SunRusty AnchorSheared Ram

Members | Asp & SnakeAtlazora's RestBig HeistBlurberry'sCloak and StaggerThe CryptDead Man's ChestDeeper LodeDragon InnEsoterican ArmsFight ArenaFlaming ArrowFlying HorseForester's ArmsGolden FieldGreen GhostHair of the DogHarpoon Joe's House of 'Rum'Hefin InnKing's AxeLaughing MinerLegless FaunLost PickaxeOther InnParamaya InnRat & BatRatpit bar(Keldagrim) (Port Sarim) (Varrock)Rellekka Longhall BarSkull in a ChestStick Your Ore InnSunlight's SanctumToad and Chicken(Games Room)Warrens PubWhite Wolf Tunnel PubThe Windbreaker