[Music Track: Beneath_the_Kingdom]

Beneath the Kingdom(#658)







Released | 16 June2021(Update)

Members | Yes

Location | Catacombs of Kourend,Giants' Den

Unlock hint | This track unlocks in the Catacombs of Kourend.

Quest | No

Instruments | Acoustic Grand Piano, Celesta, Church Organ, String Ensemble 1, Choir Aahs, Pad 8 (sweep), FX 3 (crystal), FX 6 (goblins), Custom Percussion

Duration | 04:48

Composer | Ashton Mills



Map



Beneath the Kingdomis amusictrack unlocked upon entering theCatacombs of KourendandGiants' Den.

Trivia[edit|edit source]

The music track was not released alongside the Catacombs of Kourend on9 June2016. Rather,Arcanewas played instead.

v•t•eCatacombs of Kourend

NPCs | LilliaKineerManPirate

Monsters | Demon's RunAbyssal demonBlack demonGhostGreater demonGreater NechryaelHill GiantMutated BloodveldLesser demonDragon's DenBronze dragonBrutal black dragonBrutal blue dragonBrutal red dragonFire giantHellhoundIron dragonSteel dragonReeking CoveAnkouCyclopesDeviant spectreGhostHill GiantMagic axeMoss giantPossessed pickaxeShadeSkeletonTwisted BansheeThe ShallowsCyclopsDagannothDust devilKing Sand CrabMoss giantWarped Jelly | Demon's Run | Abyssal demonBlack demonGhostGreater demonGreater NechryaelHill GiantMutated BloodveldLesser demon | Dragon's Den | Bronze dragonBrutal black dragonBrutal blue dragonBrutal red dragonFire giantHellhoundIron dragonSteel dragon | Reeking Cove | AnkouCyclopesDeviant spectreGhostHill GiantMagic axeMoss giantPossessed pickaxeShadeSkeletonTwisted Banshee | The Shallows | CyclopsDagannothDust devilKing Sand CrabMoss giantWarped Jelly

Demon's Run | Abyssal demonBlack demonGhostGreater demonGreater NechryaelHill GiantMutated BloodveldLesser demon

Dragon's Den | Bronze dragonBrutal black dragonBrutal blue dragonBrutal red dragonFire giantHellhoundIron dragonSteel dragon

Reeking Cove | AnkouCyclopesDeviant spectreGhostHill GiantMagic axeMoss giantPossessed pickaxeShadeSkeletonTwisted Banshee

The Shallows | CyclopsDagannothDust devilKing Sand CrabMoss giantWarped Jelly

Skotizo | SkotizoReanimated demon spawnDark AnkouAwakened AltarDark totem baseDark totem middleDark totem topDark totemDark clawSkotos

Upgrades | Ancient shardArclightPurple slayer helmet(imbued)

Other | Great KourendAltar (Catacombs of Kourend)

v•t•eMusic

Game-related | Music PlayerMusic capeOlaf the Bard

Lists | Music tracks(F2P)Boss musicJinglesRelease datesUnlisted musicUnlock map(Classic•F2P)Sound IDs

Official Soundtracks | RuneScape: Original Soundtrack ClassicsRuneScape: The Orchestral CollectionRuneScape: Song of the ElvesRuneScape: Theatre of BloodRuneScape: DarkmeyerRuneScape: Kebos LowlandsRuneScape: Old School Combat ClassicsOld School RuneScape: Between Two WorldsRuneScape: Battleaxes and BalladsRuneScape: Old School Runebreaks

Musical instruments | BellsChurch organCowbellsCrystal chimeEnchanted lyreOrganPenguin bongosSlayer bellSnake charmWindchimes

Items with sound | BullroarerCommorb(v2)Rubber chickenYo-yo

Emotes with sound | BeckonSkill CapeAir GuitarUri transformRelic unlockTrick