[Music Track: Dangerous_Way]

Dangerous Way(#298)







Released | 9 May2005(Update)

Members | Yes

Location | Barrows

Unlock hint | This track unlocks in the Barrows.

Quest | No

Instruments | Xylophone, Tubular Bells, Acoustic Guitar (steel), Timpani, String Ensemble 1, String Ensemble 2, Choir Aahs, French Horn, Ocarina, Taiko Drum, Reverse Cymbal, Percussion

Duration | 05:32

Composer | Ian Taylor



Map



Dangerous Wayis amusictrack that is unlocked inBarrowscrypts.

Versions[edit|edit source]

Version | Release | Music Track

1 | 15 February2005 | 

2 | 6 March2007 | 

v•t•eBarrows

Barrows brothers | Ahrim the BlightedDharok the WretchedGuthan the InfestedKaril the TaintedTorag the CorruptedVerac the Defiled

Monsters | BloodwormCrypt rat(Giant)Crypt spider(Giant)Skeleton

Rewards(Barrows equipment) | AhrimSetHoodRobe topRobe skirtStaffDharokSetHelmPlatebodyPlatelegsGreataxeGuthanSetHelmPlatebodyChainskirtWarspearKarilSetCoifLeathertopLeatherskirtCrossbow(Bolt rack)ToragSetHelmPlatebodyPlatelegsHammersVeracSetHelmBrassardPlateskirtFlail | Ahrim | SetHoodRobe topRobe skirtStaff | Dharok | SetHelmPlatebodyPlatelegsGreataxe | Guthan | SetHelmPlatebodyChainskirtWarspear | Karil | SetCoifLeathertopLeatherskirtCrossbow(Bolt rack) | Torag | SetHelmPlatebodyPlatelegsHammers | Verac | SetHelmBrassardPlateskirtFlail

Ahrim | SetHoodRobe topRobe skirtStaff

Dharok | SetHelmPlatebodyPlatelegsGreataxe

Guthan | SetHelmPlatebodyChainskirtWarspear

Karil | SetCoifLeathertopLeatherskirtCrossbow(Bolt rack)

Torag | SetHelmPlatebodyPlatelegsHammers

Verac | SetHelmBrassardPlateskirtFlail

Music | Dance of the UndeadDangerous Way

Related | StrategiesStrange Old ManCrumbling tomeStrange old lockpickBarrows chestHis Faithful ServantsThe Fall of Six

v•t•eMusic

Game-related | Music PlayerMusic capeOlaf the Bard

Lists | Music tracks(F2P)Boss musicJinglesRelease datesUnlisted musicUnlock map(Classic•F2P)Sound IDs

Official Soundtracks | RuneScape: Original Soundtrack ClassicsRuneScape: The Orchestral CollectionRuneScape: Song of the ElvesRuneScape: Theatre of BloodRuneScape: DarkmeyerRuneScape: Kebos LowlandsRuneScape: Old School Combat ClassicsOld School RuneScape: Between Two WorldsRuneScape: Battleaxes and BalladsRuneScape: Old School Runebreaks

Musical instruments | BellsChurch organCowbellsCrystal chimeEnchanted lyreOrganPenguin bongosSlayer bellSnake charmWindchimes

Items with sound | BullroarerCommorb(v2)Rubber chickenYo-yo

Emotes with sound | BeckonSkill CapeAir GuitarUri transformRelic unlockTrick