[Music Track: Far_Away]

Far Away(#311)







Released | 19 July2005(Update)

Members | Yes

Location | Lletya

Unlock hint | This track unlocks during the Mourning's End Part I quest.

Quest | Mourning's End Part I

Instruments | Celesta, Acoustic Bass, Violin, Orchestral Harp, Choir Aahs, English Horn, Piccolo, Flute, Recorder, Pan Flute, Pad 2 (warm), Percussion

Duration | 04:34

Composer | Ian Taylor



Map



Far Awayis amusictrack that is unlocked inLletya.

Versions[edit|edit source]

Version | Release | Music Track

1 | 26 – 31 January 2005 | 

2 | 6 March2007 | 

v•t•eMusic

Game-related | Music PlayerMusic capeOlaf the Bard

Lists | Music tracks(F2P)Boss musicJinglesRelease datesUnlisted musicUnlock map(Classic•F2P)Sound IDs

Official Soundtracks | RuneScape: Original Soundtrack ClassicsRuneScape: The Orchestral CollectionRuneScape: Song of the ElvesRuneScape: Theatre of BloodRuneScape: DarkmeyerRuneScape: Kebos LowlandsRuneScape: Old School Combat ClassicsOld School RuneScape: Between Two WorldsRuneScape: Battleaxes and BalladsRuneScape: Old School Runebreaks

Musical instruments | BellsChurch organCowbellsCrystal chimeEnchanted lyreOrganPenguin bongosSlayer bellSnake charmWindchimes

Items with sound | BullroarerCommorb(v2)Rubber chickenYo-yo

Emotes with sound | BeckonSkill CapeAir GuitarUri transformRelic unlockTrick

v•t•eMourning's End Part I

NPCs | ElunedArianwynOronwenTegidMournerEssylltGnomeSlaveRed SheepGreen SheepBlue SheepYellow SheepElena

Items | Crystal teleport seedTeleport crystalSieveTegid's soapTarnished keyMourner letterFractionation stillBig book of bangsToxic powderBarrelAppleRotten applesCoal tarNaphthaToxic naphthaNaphtha apple mixMourner outfitMaskTop(Bloody)Trousers(Ripped)BootsGlovesCloakDevicesFixedBrokenSwamp toadsRedYellowGreenBlueOgre bellowsRedYellowGreenBlueBooksPrifddinas' historyEastern discoveryEastern settlementThe great divideUnobtainableWorn key |  | Crystal teleport seedTeleport crystalSieveTegid's soapTarnished keyMourner letter | Fractionation still | Big book of bangsToxic powderBarrelAppleRotten applesCoal tarNaphthaToxic naphthaNaphtha apple mix | Mourner outfit | MaskTop(Bloody)Trousers(Ripped)BootsGlovesCloak | Devices | FixedBroken | Swamp toads | RedYellowGreenBlue | Ogre bellows | RedYellowGreenBlue | Books | Prifddinas' historyEastern discoveryEastern settlementThe great divide | Unobtainable | Worn key

 | Crystal teleport seedTeleport crystalSieveTegid's soapTarnished keyMourner letter

Fractionation still | Big book of bangsToxic powderBarrelAppleRotten applesCoal tarNaphthaToxic naphthaNaphtha apple mix

Mourner outfit | MaskTop(Bloody)Trousers(Ripped)BootsGlovesCloak

Devices | FixedBroken

Swamp toads | RedYellowGreenBlue

Ogre bellows | RedYellowGreenBlue

Books | Prifddinas' historyEastern discoveryEastern settlementThe great divide

Unobtainable | Worn key

Locations | IsafdarMourner HeadquartersMourner TunnelsPoison WasteWest Ardougne

Music | Fight or FlightFar Away

Miscellaneous | Quick guideTranscript