[Music Track: Fe_Fi_Fo_Fum]

Fe Fi Fo Fum(#474)







Released | 4 June2007(Update)

Members | Yes

Location | Top of the beanstalk

Unlock hint | This track unlocks during the Grim Tales quest.

Quest | Grim Tales

Instruments | Tremolo Strings, Pizzicato Strings, Timpani, Trombone, French Horn, Brass Section, Percussion

Duration | 03:13

Platforms | Spotify, Vinyl, Compact Disc

Album | RuneScape: Original Soundtrack Classics

Composer | Adam Bond



Map



Fe Fi Fo Fumis amusictrack that is unlocked during the fight withGlodin theGrim Talesquest.

Trivia[edit|edit source]

"Fe Fi Fo Fum" refers to the historical couplet used inJack and the Beanstalk.

v•t•eGrim Tales

NPCs | SylasRupert the BeardMiazrqaGrimgnashWinkinGnomeMonstersExperiment No.2GlodMouse |  | SylasRupert the BeardMiazrqaGrimgnashWinkinGnome | Monsters | Experiment No.2GlodMouse

 | SylasRupert the BeardMiazrqaGrimgnashWinkinGnome

Monsters | Experiment No.2GlodMouse

Items | Magic beansGriffin featherMiazrqa's pendantDoor keyMusic sheetShrinking recipeTo-do listShrunk oglerootRupert's helmetDwarven helmetGolden goblin

Scenery | Bean MoundBeardBeanstumpEarth MoundLockMusic stand

Locations | Mouse holeTaverleyWhite Wolf Mountain

Music | Fe Fi Fo FumMouse Trap

Related | Quick guideTranscriptDrain PipeGubblebak

v•t•eMusic

Game-related | Music PlayerMusic capeOlaf the Bard

Lists | Music tracks(F2P)Boss musicJinglesRelease datesUnlisted musicUnlock map(Classic•F2P)Sound IDs

Official Soundtracks | RuneScape: Original Soundtrack ClassicsRuneScape: The Orchestral CollectionRuneScape: Song of the ElvesRuneScape: Theatre of BloodRuneScape: DarkmeyerRuneScape: Kebos LowlandsRuneScape: Old School Combat ClassicsOld School RuneScape: Between Two WorldsRuneScape: Battleaxes and BalladsRuneScape: Old School Runebreaks

Musical instruments | BellsChurch organCowbellsCrystal chimeEnchanted lyreOrganPenguin bongosSlayer bellSnake charmWindchimes

Items with sound | BullroarerCommorb(v2)Rubber chickenYo-yo

Emotes with sound | BeckonSkill CapeAir GuitarUri transformRelic unlockTrick