[Music Track: Race_Against_the_Clock]

Race Against the Clock(#652)







Released | 14 April2021(Update)

Members | No

Location | Ruins of Camdozaal

Unlock hint | This track unlocks in the Camdozaal Vault.

Quest | Below Ice Mountain

Instruments | Acoustic Grand Piano, Bright Acoustic Piano, Music Box, Pizzicato Strings, Orchestral Harp, String Ensemble 1, Orchestra Hit, Brass Section, FX 3 (crystal), Reverse Cymbal, Percussion, Custom Choir

Duration | 01:26

Composer | Julian Surma



Map



Race Against the Clockis amusictrack that is unlocked in theCamdozaal Vault. 750Barronite shardsare required to access the vault and unlock the track.

The music track takes exactly one minute to match the allotted time in the Camdozaal Vault, while the remaining 26 seconds are silent.

v•t•eRuins of Camdozaal

Central hub | RamarnoRamarno's Shard ExchangeSacred Forge

Monsters | Ancient GuardianGolemsFlawedMindBodyChaos |  | Ancient Guardian | Golems | FlawedMindBodyChaos

 | Ancient Guardian

Golems | FlawedMindBodyChaos

Items | BarroniteShardsDepositMaceHandleGuardHeadMaceRelicsGlobeLedgerAstroscopeTreatiseCarcanetFishGuppy(raw) (ruined)Cavefish(raw) (ruined)Tetra(raw) (ruined)Catfish(raw) (ruined)CoresMindBodyChaosLockboxesSimpleElaborateOrnateOtherImcando hammer(broken•off-hand) | Barronite | ShardsDeposit | Mace | HandleGuardHeadMace | Relics | GlobeLedgerAstroscopeTreatiseCarcanet | Fish | Guppy(raw) (ruined)Cavefish(raw) (ruined)Tetra(raw) (ruined)Catfish(raw) (ruined) | Cores | MindBodyChaos | Lockboxes | SimpleElaborateOrnate | Other | Imcando hammer(broken•off-hand)

Barronite | ShardsDeposit

Mace | HandleGuardHeadMace

Relics | GlobeLedgerAstroscopeTreatiseCarcanet

Fish | Guppy(raw) (ruined)Cavefish(raw) (ruined)Tetra(raw) (ruined)Catfish(raw) (ruined)

Cores | MindBodyChaos

Lockboxes | SimpleElaborateOrnate

Other | Imcando hammer(broken•off-hand)

Skilling | RocksFishing spotBarronite CrusherPreparation TableAltar

Charms | FishingPreparationDefenceMiningLuckBoost

Music | Race Against the ClockThe Ruins of Camdozaal

Related | Ice MountainLassarBelow Ice MountainCamdozaal MinesCamdozaal VaultFrogGhostVault Door

v•t•eMusic

Game-related | Music PlayerMusic capeOlaf the Bard

Lists | Music tracks(F2P)Boss musicJinglesRelease datesUnlisted musicUnlock map(Classic•F2P)Sound IDs

Official Soundtracks | RuneScape: Original Soundtrack ClassicsRuneScape: The Orchestral CollectionRuneScape: Song of the ElvesRuneScape: Theatre of BloodRuneScape: DarkmeyerRuneScape: Kebos LowlandsRuneScape: Old School Combat ClassicsOld School RuneScape: Between Two WorldsRuneScape: Battleaxes and BalladsRuneScape: Old School Runebreaks

Musical instruments | BellsChurch organCowbellsCrystal chimeEnchanted lyreOrganPenguin bongosSlayer bellSnake charmWindchimes

Items with sound | BullroarerCommorb(v2)Rubber chickenYo-yo

Emotes with sound | BeckonSkill CapeAir GuitarUri transformRelic unlockTrick