[Music Track: Rat_a_Tat_Tat]

Rat a Tat Tat(#345)







Released | 28 November2005(Update)

Members | Yes

Location | VarrockRat Pits

Unlock hint | This track unlocks at the Varrock Rat Pits.

Quest | Ratcatchers

Instruments | Xylophone, Accordion, Tango Accordion, Pizzicato Strings, Timpani, String Ensemble 2, French Horn, Bassoon, Flute, Fiddle, Percussion

Duration | 02:55

Composer | Ian Taylor



Map



Rat a Tat Tatis amusictrack that is unlocked by entering theVarrockRat Pits.

Versions[edit|edit source]

Version | Release | Music Track

1 | 12 – 19 September 2005 | 

2 | 6 March2007 | 

v•t•eMusic

Game-related | Music PlayerMusic capeOlaf the Bard

Lists | Music tracks(F2P)Boss musicJinglesRelease datesUnlisted musicUnlock map(Classic•F2P)Sound IDs

Official Soundtracks | RuneScape: Original Soundtrack ClassicsRuneScape: The Orchestral CollectionRuneScape: Song of the ElvesRuneScape: Theatre of BloodRuneScape: DarkmeyerRuneScape: Kebos LowlandsRuneScape: Old School Combat ClassicsOld School RuneScape: Between Two WorldsRuneScape: Battleaxes and BalladsRuneScape: Old School Runebreaks

Musical instruments | BellsChurch organCowbellsCrystal chimeEnchanted lyreOrganPenguin bongosSlayer bellSnake charmWindchimes

Items with sound | BullroarerCommorb(v2)Rubber chickenYo-yo

Emotes with sound | BeckonSkill CapeAir GuitarUri transformRelic unlockTrick

v•t•eRatcatchers

NPCs | GertrudeGrimesquitPhingspetJimmy DazzlerHooknosed JackSmokin' JoeThe FaceFelkrashAli the Snake CharmerApothecaryKing ratGamerMansion AttendantsGuardCouncillor HalgriveSpice sellerAli MorrisaneSilk merchantZeneshaSilver merchantCeril CarnilleanFur traderGem merchantCatsTrottersBonesPoxThe BeastBellemorde |  | GertrudeGrimesquitPhingspetJimmy DazzlerHooknosed JackSmokin' JoeThe FaceFelkrashAli the Snake CharmerApothecaryKing ratGamer | Mansion Attendants | GuardCouncillor HalgriveSpice sellerAli MorrisaneSilk merchantZeneshaSilver merchantCeril CarnilleanFur traderGem merchant | Cats | TrottersBonesPoxThe BeastBellemorde

 | GertrudeGrimesquitPhingspetJimmy DazzlerHooknosed JackSmokin' JoeThe FaceFelkrashAli the Snake CharmerApothecaryKing ratGamer

Mansion Attendants | GuardCouncillor HalgriveSpice sellerAli MorrisaneSilk merchantZeneshaSilver merchantCeril CarnilleanFur traderGem merchant

Cats | TrottersBonesPoxThe BeastBellemorde

Items | Cat antipoisonDirectionsMusic scrollPoisoned cheesePot of weedsSmouldering potRat poisonBook (Ratpits)

Rewards | Rat poleRat Pits

Locations and scenery | LocationsRatcatchers MansionVarrockPort SarimEast ArdougneRat PitsSceneryStale beer barrelMoney Pot | Locations | Ratcatchers MansionVarrockPort SarimEast ArdougneRat Pits | Scenery | Stale beer barrelMoney Pot

Locations | Ratcatchers MansionVarrockPort SarimEast ArdougneRat Pits

Scenery | Stale beer barrelMoney Pot

Music | The Noble RodentRat HuntBubble and SqueakSarim's VerminRat a Tat TatCatch Me If You Can

Miscellaneous | Quick guide

v•t•eRat Pits

NPCs | RatGamerBarmanEast ArdougneJimmy DazzlerBonesClaudeTopsyVarrockHooknosed JackPoxGertrude's catTreacleMittensKeldagrimSmokin' JoeThe BeastAnleifFiorOxiRaubornSagiraVaeringkCaptain TomLokiPort SarimThe FaceBellemordeFelkrashTurbogroomerPusskins |  | RatGamerBarman | East Ardougne | Jimmy DazzlerBonesClaudeTopsy | Varrock | Hooknosed JackPoxGertrude's catTreacleMittens | Keldagrim | Smokin' JoeThe BeastAnleifFiorOxiRaubornSagiraVaeringkCaptain TomLoki | Port Sarim | The FaceBellemordeFelkrashTurbogroomerPusskins

 | RatGamerBarman

East Ardougne | Jimmy DazzlerBonesClaudeTopsy

Varrock | Hooknosed JackPoxGertrude's catTreacleMittens

Keldagrim | Smokin' JoeThe BeastAnleifFiorOxiRaubornSagiraVaeringkCaptain TomLoki

Port Sarim | The FaceBellemordeFelkrashTurbogroomerPusskins

Shops | Ratpit bar

Scenery | Rat trap

Music | Bubble and SqueakCatch Me If You CanRat a Tat TatSarim's Vermin