[Music Track: Ready_for_the_Hunt]

Ready for the Hunt(#765)







Released | 20 March2024(Update)

Members | Yes

Location | Hunter Guild

Unlock hint | This track unlocks in the Hunter Guild.

Quest | No

Duration | 04:04

Composer | Grace Docksey



Map



Ready for the Huntis amusictrack that is unlocked in theHunter Guild, as well as its basement.

v•t•eHunter Guild

NPCs | Guildmaster ApaturaGuild Scribe VeritySoar Leader PitriImiaOrsagaPellemBankerBank buffaloGuild HuntersHuntmaster GilmanOrnusCervusAcoTecoWolfFoxKiko |  | Guildmaster ApaturaGuild Scribe VeritySoar Leader PitriImiaOrsagaPellemBankerBank buffalo | Guild Hunters | Huntmaster GilmanOrnusCervusAcoTecoWolfFoxKiko

 | Guildmaster ApaturaGuild Scribe VeritySoar Leader PitriImiaOrsagaPellemBankerBank buffalo

Guild Hunters | Huntmaster GilmanOrnusCervusAcoTecoWolfFoxKiko

Hunters' Rumours | Rare creature partsTuftsKebbityGrey chinchompaRed chinchompaHerbyWingsBlue butterflyWhite butterflyBlack butterflySunlight mothMoonlight mothClawsSwamp lizardOrange salamanderRed salamanderTecu salamanderOtherTailfeathersLarupia earLarge jerboa tailGraahk horn spurKyatt tooth chipFox fluffAntelope hoof shard (sunlight)Antelope hoof shard (moonlight)RewardsHunters' loot sacksBasicAdeptExpertMasterSuppliesQuetzal whistle blueprintsBasicEnhanced(torn)Perfected(torn)Quetzal whistlesBasicEnhancedPerfectedGuild hunter outfitHeadwearTopLegsBootsOtherHunter spear tipsHuntsman's kitQuetzal feedTattered request noteGuild history excerptApatura's keyApatura's noteQuetzin | Rare creature parts | TuftsKebbityGrey chinchompaRed chinchompaHerbyWingsBlue butterflyWhite butterflyBlack butterflySunlight mothMoonlight mothClawsSwamp lizardOrange salamanderRed salamanderTecu salamanderOtherTailfeathersLarupia earLarge jerboa tailGraahk horn spurKyatt tooth chipFox fluffAntelope hoof shard (sunlight)Antelope hoof shard (moonlight) | Tufts | KebbityGrey chinchompaRed chinchompaHerby | Wings | Blue butterflyWhite butterflyBlack butterflySunlight mothMoonlight moth | Claws | Swamp lizardOrange salamanderRed salamanderTecu salamander | Other | TailfeathersLarupia earLarge jerboa tailGraahk horn spurKyatt tooth chipFox fluffAntelope hoof shard (sunlight)Antelope hoof shard (moonlight) | Rewards | Hunters' loot sacksBasicAdeptExpertMasterSuppliesQuetzal whistle blueprintsBasicEnhanced(torn)Perfected(torn)Quetzal whistlesBasicEnhancedPerfectedGuild hunter outfitHeadwearTopLegsBootsOtherHunter spear tipsHuntsman's kitQuetzal feedTattered request noteGuild history excerptApatura's keyApatura's noteQuetzin | Hunters' loot sacks | BasicAdeptExpertMasterSupplies | Quetzal whistle blueprints | BasicEnhanced(torn)Perfected(torn) | Quetzal whistles | BasicEnhancedPerfected | Guild hunter outfit | HeadwearTopLegsBoots | Other | Hunter spear tipsHuntsman's kitQuetzal feedTattered request noteGuild history excerptApatura's keyApatura's noteQuetzin

Rare creature parts | TuftsKebbityGrey chinchompaRed chinchompaHerbyWingsBlue butterflyWhite butterflyBlack butterflySunlight mothMoonlight mothClawsSwamp lizardOrange salamanderRed salamanderTecu salamanderOtherTailfeathersLarupia earLarge jerboa tailGraahk horn spurKyatt tooth chipFox fluffAntelope hoof shard (sunlight)Antelope hoof shard (moonlight) | Tufts | KebbityGrey chinchompaRed chinchompaHerby | Wings | Blue butterflyWhite butterflyBlack butterflySunlight mothMoonlight moth | Claws | Swamp lizardOrange salamanderRed salamanderTecu salamander | Other | TailfeathersLarupia earLarge jerboa tailGraahk horn spurKyatt tooth chipFox fluffAntelope hoof shard (sunlight)Antelope hoof shard (moonlight)

Tufts | KebbityGrey chinchompaRed chinchompaHerby

Wings | Blue butterflyWhite butterflyBlack butterflySunlight mothMoonlight moth

Claws | Swamp lizardOrange salamanderRed salamanderTecu salamander

Other | TailfeathersLarupia earLarge jerboa tailGraahk horn spurKyatt tooth chipFox fluffAntelope hoof shard (sunlight)Antelope hoof shard (moonlight)

Rewards | Hunters' loot sacksBasicAdeptExpertMasterSuppliesQuetzal whistle blueprintsBasicEnhanced(torn)Perfected(torn)Quetzal whistlesBasicEnhancedPerfectedGuild hunter outfitHeadwearTopLegsBootsOtherHunter spear tipsHuntsman's kitQuetzal feedTattered request noteGuild history excerptApatura's keyApatura's noteQuetzin | Hunters' loot sacks | BasicAdeptExpertMasterSupplies | Quetzal whistle blueprints | BasicEnhanced(torn)Perfected(torn) | Quetzal whistles | BasicEnhancedPerfected | Guild hunter outfit | HeadwearTopLegsBoots | Other | Hunter spear tipsHuntsman's kitQuetzal feedTattered request noteGuild history excerptApatura's keyApatura's noteQuetzin

Hunters' loot sacks | BasicAdeptExpertMasterSupplies

Quetzal whistle blueprints | BasicEnhanced(torn)Perfected(torn)

Quetzal whistles | BasicEnhancedPerfected

Guild hunter outfit | HeadwearTopLegsBoots

Other | Hunter spear tipsHuntsman's kitQuetzal feedTattered request noteGuild history excerptApatura's keyApatura's noteQuetzin

Related | Mixed hide baseImia's SuppliesPellem's Fur StoreThe Burrow

v•t•eMusic

Game-related | Music PlayerMusic capeOlaf the Bard

Lists | Music tracks(F2P)Boss musicJinglesRelease datesUnlisted musicUnlock map(Classic•F2P)Sound IDs

Official Soundtracks | RuneScape: Original Soundtrack ClassicsRuneScape: The Orchestral CollectionRuneScape: Song of the ElvesRuneScape: Theatre of BloodRuneScape: DarkmeyerRuneScape: Kebos LowlandsRuneScape: Old School Combat ClassicsOld School RuneScape: Between Two WorldsRuneScape: Battleaxes and BalladsRuneScape: Old School Runebreaks

Musical instruments | BellsChurch organCowbellsCrystal chimeEnchanted lyreOrganPenguin bongosSlayer bellSnake charmWindchimes

Items with sound | BullroarerCommorb(v2)Rubber chickenYo-yo

Emotes with sound | BeckonSkill CapeAir GuitarUri transformRelic unlockTrick