[Music Track: Rising_Damp]

Rising Damp(#462)







Released | 10 April2007(Update)

Members | Yes

Location | Brine Rat Cavern

Unlock hint | This track unlocks in the Brine Rat Cavern.

Quest | Olaf's Quest

Instruments | Marimba, Tubular Bells, Pizzicato Strings, Clarinet, Bottle Blow, Ocarina, Woodblock, Taiko Drum, Melodic Tom, Seashore

Duration | 04:29

Composer | Adam Bond



Map



Rising Dampis amusictrack that is unlocked in theBrine Rat CavernduringOlaf's Quest.

Changes[edit|edit source]

Date | Changes

1 March2018(update) | Added unlock hint for this track: 'This track unlocks in the Brine Rat Cavern.'

v•t•eOlaf's Quest

NPCs | Olaf HradsonIngrid HradsonVolf OlafsonSven the HelmsmanEnemiesUlfricSkeleton fremennik |  | Olaf HradsonIngrid HradsonVolf OlafsonSven the Helmsman | Enemies | UlfricSkeleton fremennik

 | Olaf HradsonIngrid HradsonVolf OlafsonSven the Helmsman

Enemies | UlfricSkeleton fremennik

Items | Windswept logsCrude carvingCruder carvingDamp planksSven's last mapKeyRotten barrelBrine sabreParchment

Scenery | Olaf's boatWindswept treeChest

Music | Rising Damp

Related | Quick guideTranscriptBrine Rat CavernBrine rat

v•t•eMusic

Game-related | Music PlayerMusic capeOlaf the Bard

Lists | Music tracks(F2P)Boss musicJinglesRelease datesUnlisted musicUnlock map(Classic•F2P)Sound IDs

Official Soundtracks | RuneScape: Original Soundtrack ClassicsRuneScape: The Orchestral CollectionRuneScape: Song of the ElvesRuneScape: Theatre of BloodRuneScape: DarkmeyerRuneScape: Kebos LowlandsRuneScape: Old School Combat ClassicsOld School RuneScape: Between Two WorldsRuneScape: Battleaxes and BalladsRuneScape: Old School Runebreaks

Musical instruments | BellsChurch organCowbellsCrystal chimeEnchanted lyreOrganPenguin bongosSlayer bellSnake charmWindchimes

Items with sound | BullroarerCommorb(v2)Rubber chickenYo-yo

Emotes with sound | BeckonSkill CapeAir GuitarUri transformRelic unlockTrick