[Music Track: Sarachnis_(music_track)]

Sarachnis(#602)







Released | 4 July2019(Update)

Members | Yes

Location | Sarachnis' lair

Unlock hint | This track unlocks while fighting Sarachnis.

Quest | No

Instruments | Acoustic Grand Piano, Tubular Bells, Timpani, Orchestra Hit, French Horn, Brass Section, FX 3 (crystal), Percussion, Custom Choir

Duration | 06:14

Composer | Julian Surma



Map



Sarachnisis amusictrack that is unlocked during the fight withSarachnis.

v•t•eForthos Dungeon

NPCs | Brother AimeriEodanKnight of VarlamoreOlbertus

Monsters | Shaeded BeastUndead DruidRed dragon(baby)Temple SpiderSarachnis(spawn)

Items | TomesTome of the sunTome of the moonTome of the templeTattered pagesTattered sun pageTattered moon pageTattered temple pageSarachnisGiant egg sacSarachnis cudgelJar of eyesSrarachaOtherGrubby keyBlue egg sacOrange egg sacMask of ranulTemple keyTemple coin | Tomes | Tome of the sunTome of the moonTome of the temple | Tattered pages | Tattered sun pageTattered moon pageTattered temple page | Sarachnis | Giant egg sacSarachnis cudgelJar of eyesSraracha | Other | Grubby keyBlue egg sacOrange egg sacMask of ranulTemple keyTemple coin

Tomes | Tome of the sunTome of the moonTome of the temple

Tattered pages | Tattered sun pageTattered moon pageTattered temple page

Sarachnis | Giant egg sacSarachnis cudgelJar of eyesSraracha

Other | Grubby keyBlue egg sacOrange egg sacMask of ranulTemple keyTemple coin

Scenery | InteractiveAltarBroken sun altarCursed AltarGrubby ChestSacred Bone BurnerStone ReliefStrange passageDecorativeEgg sacEmpty sacEmpty sarcophagus | Interactive | AltarBroken sun altarCursed AltarGrubby ChestSacred Bone BurnerStone ReliefStrange passage | Decorative | Egg sacEmpty sacEmpty sarcophagus

Interactive | AltarBroken sun altarCursed AltarGrubby ChestSacred Bone BurnerStone ReliefStrange passage

Decorative | Egg sacEmpty sacEmpty sarcophagus

Other | In Search of KnowledgeRalosRanulSarachnis (music track)A Forgotten Religion

v•t•eMusic

Game-related | Music PlayerMusic capeOlaf the Bard

Lists | Music tracks(F2P)Boss musicJinglesRelease datesUnlisted musicUnlock map(Classic•F2P)Sound IDs

Official Soundtracks | RuneScape: Original Soundtrack ClassicsRuneScape: The Orchestral CollectionRuneScape: Song of the ElvesRuneScape: Theatre of BloodRuneScape: DarkmeyerRuneScape: Kebos LowlandsRuneScape: Old School Combat ClassicsOld School RuneScape: Between Two WorldsRuneScape: Battleaxes and BalladsRuneScape: Old School Runebreaks

Musical instruments | BellsChurch organCowbellsCrystal chimeEnchanted lyreOrganPenguin bongosSlayer bellSnake charmWindchimes

Items with sound | BullroarerCommorb(v2)Rubber chickenYo-yo

Emotes with sound | BeckonSkill CapeAir GuitarUri transformRelic unlockTrick