[Music Track: Snowflake_%26_My_Arm]

Snowflake & My Arm(#580)







Released | 6 September2018(Update)

Members | Yes

Location | Weiss

Unlock hint | This track unlocks during the Making Friends with My Arm quest.

Quest | Making Friends with My Arm

Instruments | Acoustic Grand Piano, Harmonica, Bassoon

Duration | 1:17

Composer | Ashleigh Bridges



Snowflake & My Armis amusictrack unlocked during the ending cutscene ofMaking Friends with My Arm. At 1 minute and 17 seconds, it is the shortest listed music track in Old School RuneScape.

v•t•eMaking Friends with My Arm

NPCs | BurntmeatMy ArmLarryWise Old ManApothecaryWeisstrollsBoulderButterflyDon't Know WhatDriftwoodGoat PooIcicleMotherOdd MushroomOdd StonePebbleRootSnowflakeSquirrelWolfboneYellow Snow |  | BurntmeatMy ArmLarryWise Old ManApothecary | Weisstrolls | BoulderButterflyDon't Know WhatDriftwoodGoat PooIcicleMotherOdd MushroomOdd StonePebbleRootSnowflakeSquirrelWolfboneYellow Snow

 | BurntmeatMy ArmLarryWise Old ManApothecary

Weisstrolls | BoulderButterflyDon't Know WhatDriftwoodGoat PooIcicleMotherOdd MushroomOdd StonePebbleRootSnowflakeSquirrelWolfboneYellow Snow

Items | Reduced cadava potionOld man's coffinGoat dungWeiss fire notes

Rewards | Basalt(rocks)Icy basaltStony basaltSaltsTe salt(rocks)Efh salt(rocks)Urt salt(rocks)Fire pitsOld fire pitFire of Eternal LightFire of NourishmentFire of DehumidificationFire of Unseasonal Warmth |  | Basalt(rocks)Icy basaltStony basalt | Salts | Te salt(rocks)Efh salt(rocks)Urt salt(rocks) | Fire pits | Old fire pitFire of Eternal LightFire of NourishmentFire of DehumidificationFire of Unseasonal Warmth

 | Basalt(rocks)Icy basaltStony basalt

Salts | Te salt(rocks)Efh salt(rocks)Urt salt(rocks)

Fire pits | Old fire pitFire of Eternal LightFire of NourishmentFire of DehumidificationFire of Unseasonal Warmth

Locations | Troll StrongholdWeissDraynor VillageSalt Mine

Music | Barren LandLumberingMother RuckusSnowflake & My ArmTroll Shuffle

Related | Quick guideTranscriptFire of DominationCoffin hotspot

v•t•eMusic

Game-related | Music PlayerMusic capeOlaf the Bard

Lists | Music tracks(F2P)Boss musicJinglesRelease datesUnlisted musicUnlock map(Classic•F2P)Sound IDs

Official Soundtracks | RuneScape: Original Soundtrack ClassicsRuneScape: The Orchestral CollectionRuneScape: Song of the ElvesRuneScape: Theatre of BloodRuneScape: DarkmeyerRuneScape: Kebos LowlandsRuneScape: Old School Combat ClassicsOld School RuneScape: Between Two WorldsRuneScape: Battleaxes and BalladsRuneScape: Old School Runebreaks

Musical instruments | BellsChurch organCowbellsCrystal chimeEnchanted lyreOrganPenguin bongosSlayer bellSnake charmWindchimes

Items with sound | BullroarerCommorb(v2)Rubber chickenYo-yo

Emotes with sound | BeckonSkill CapeAir GuitarUri transformRelic unlockTrick