[Music Track: Sorceress%27s_Garden_(music_track)]

Sorceress's Garden(#703)







Released | 12 February2007(Update)

Members | Yes

Location | Sorceress's Garden

Unlock hint | This track unlocks in the Sorceress's Garden.

Quest | None

Instruments | Pizzicato Strings, Pad 2 (warm), Percussion

Duration | 01:28

Composer | Ian Taylor



Sorceress's Gardenis amusictrack that plays at theSorceress's Garden. It can be heard in the centre of the garden near the fountain.

Versions[edit|edit source]

Version | Release | Music Track

2 | 12 February2007 | 

3 | 6 March2007 | 

Changes[edit|edit source]

Date | Changes

27 April2022(update) | The music track is now listed in theMusic Player.

v•t•eSorceress's Garden

NPCs | ApprenticeDel-MontyOsmanSelimSorceress

Sq'irks | WinterSpringAutumnSummer

Sq'irkjuice | WinterSpringAutumnSummer

Elementals | WinterSpringAutumnSummer

Garden walkthroughs | WinterSpringAutumnSummer

Music | Garden of WinterGarden of SpringGarden of AutumnGarden of SummerSorceress's Garden

Related | HerbsSq'irk tree

v•t•eMusic

Game-related | Music PlayerMusic capeOlaf the Bard

Lists | Music tracks(F2P)Boss musicJinglesRelease datesUnlisted musicUnlock map(Classic•F2P)Sound IDs

Official Soundtracks | RuneScape: Original Soundtrack ClassicsRuneScape: The Orchestral CollectionRuneScape: Song of the ElvesRuneScape: Theatre of BloodRuneScape: DarkmeyerRuneScape: Kebos LowlandsRuneScape: Old School Combat ClassicsOld School RuneScape: Between Two WorldsRuneScape: Battleaxes and BalladsRuneScape: Old School Runebreaks

Musical instruments | BellsChurch organCowbellsCrystal chimeEnchanted lyreOrganPenguin bongosSlayer bellSnake charmWindchimes

Items with sound | BullroarerCommorb(v2)Rubber chickenYo-yo

Emotes with sound | BeckonSkill CapeAir GuitarUri transformRelic unlockTrick