[Music Track: Surok%27s_Theme]

Surok's Theme(#706)







Released | 27 March2007(Update)

Members | Yes

Location | Varrock

Unlock hint | This track unlocks during the What Lies Below quest.

Quest | What Lies Below

Instruments | Pizzicato Strings, Orchestral Harp, Timpani, Choir Aahs, Brass Section, Percussion

Duration | 03:17

Composer | Adam Bond



Surok's Themeis amusictrack that plays duringWhat Lies Below. It can be heard during the battle withKing Roald.

It can later be heard in theNightmare Zonewhen fightingKing Roald. Originally, the name "Surok's Revenge" would appear in theMusic Player, but no longer does so after it became a listed track.

Changes[edit|edit source]

Date | Changes

27 April2022(update) | The music track is now listed in theMusic Player.

v•t•eWhat Lies Below

NPCs | Rat BurgissSurok MagisAnna JonesZaffEnemiesKing RoaldOutlaw |  | Rat BurgissSurok MagisAnna JonesZaff | Enemies | King RoaldOutlaw

 | Rat BurgissSurok MagisAnna JonesZaff

Enemies | King RoaldOutlaw

Items | An empty folderUsed folderFull folderRat's paperLetter to surokSurok's letterWandInfused wandSin'keth's diaryDagon'hai historyBeacon ringZaff's instructions

Locations | Outlaw CampTunnel of Chaos

Music | Alternative RootSurok's Theme

Related | Quick guideVarrock Palace Secret GuardVPSG code

v•t•eMusic

Game-related | Music PlayerMusic capeOlaf the Bard

Lists | Music tracks(F2P)Boss musicJinglesRelease datesUnlisted musicUnlock map(Classic•F2P)Sound IDs

Official Soundtracks | RuneScape: Original Soundtrack ClassicsRuneScape: The Orchestral CollectionRuneScape: Song of the ElvesRuneScape: Theatre of BloodRuneScape: DarkmeyerRuneScape: Kebos LowlandsRuneScape: Old School Combat ClassicsOld School RuneScape: Between Two WorldsRuneScape: Battleaxes and BalladsRuneScape: Old School Runebreaks

Musical instruments | BellsChurch organCowbellsCrystal chimeEnchanted lyreOrganPenguin bongosSlayer bellSnake charmWindchimes

Items with sound | BullroarerCommorb(v2)Rubber chickenYo-yo

Emotes with sound | BeckonSkill CapeAir GuitarUri transformRelic unlockTrick