[Music Track: The_Longramble_Scramble]

The Longramble Scramble(#748)







Released | 13 September2023(Update)

Members | Yes

Location | Galarpos Mountains

Unlock hint | This track unlocks during The Path of Glouphrie quest.

Quest | The Path of Glouphrie

Duration | 04:44

Composer | Dan Atkinson



The Longramble Scrambleis amusictrack that is unlocked during the questThe Path of Glouphrie. It plays upon arriving at theGalarpos Mountains, whereLongrambleis.

v•t•eThe Path of Glouphrie

NPCs | King BolrenGolrieYewnock the EngineerKing BolrieAdvisorArgenthorgGlouphrie the UntrustedGianne jnr.LongrambleIncomitatusHazelmereTerrorbird Guard 21Terrorbird Guard 72 |  | King BolrenGolrieYewnock the EngineerKing BolrieAdvisorArgenthorgGlouphrie the UntrustedGianne jnr.LongrambleIncomitatusHazelmereTerrorbird Guard 21Terrorbird Guard 72

 | King BolrenGolrieYewnock the EngineerKing BolrieAdvisorArgenthorgGlouphrie the UntrustedGianne jnr.LongrambleIncomitatusHazelmereTerrorbird Guard 21Terrorbird Guard 72

Enemies | Cute creatureEvil creatureWarped TortoiseWarped Terrorbird

Items | Chest keyStrongroom keyCrystal chime seedCrystal chimeYewnock's notesCirclesRedOrangeYellowGreenBlueIndigoVioletTrianglesRedOrangeYellowGreenBlueIndigoVioletSquaresRedOrangeYellowGreenBlueIndigoVioletPentagonsRedOrangeYellowGreenBlueIndigoVioletRewardsMagic lamp (strength)Magic lamp (slayer)Magic lamp (thieving)Magic lamp (magic) |  | Chest keyStrongroom keyCrystal chime seedCrystal chimeYewnock's notes | Circles | RedOrangeYellowGreenBlueIndigoViolet | Triangles | RedOrangeYellowGreenBlueIndigoViolet | Squares | RedOrangeYellowGreenBlueIndigoViolet | Pentagons | RedOrangeYellowGreenBlueIndigoViolet | Rewards | Magic lamp (strength)Magic lamp (slayer)Magic lamp (thieving)Magic lamp (magic)

 | Chest keyStrongroom keyCrystal chime seedCrystal chimeYewnock's notes

Circles | RedOrangeYellowGreenBlueIndigoViolet

Triangles | RedOrangeYellowGreenBlueIndigoViolet

Squares | RedOrangeYellowGreenBlueIndigoViolet

Pentagons | RedOrangeYellowGreenBlueIndigoViolet

Rewards | Magic lamp (strength)Magic lamp (slayer)Magic lamp (thieving)Magic lamp (magic)

Scenery | Chest (wood)Chest (silver)Chest (gold)GateLecternHuman foodYewnock's machineYewnock's exchanger

Music | Bolrie's DiaryHealin' Feelin'The Longramble ScrambleStoreroom ShuffleTerrorbird TussleWaste Defaced

Related | Quick guideTranscriptPoison Waste Dungeon

v•t•eMusic

Game-related | Music PlayerMusic capeOlaf the Bard

Lists | Music tracks(F2P)Boss musicJinglesRelease datesUnlisted musicUnlock map(Classic•F2P)Sound IDs

Official Soundtracks | RuneScape: Original Soundtrack ClassicsRuneScape: The Orchestral CollectionRuneScape: Song of the ElvesRuneScape: Theatre of BloodRuneScape: DarkmeyerRuneScape: Kebos LowlandsRuneScape: Old School Combat ClassicsOld School RuneScape: Between Two WorldsRuneScape: Battleaxes and BalladsRuneScape: Old School Runebreaks

Musical instruments | BellsChurch organCowbellsCrystal chimeEnchanted lyreOrganPenguin bongosSlayer bellSnake charmWindchimes

Items with sound | BullroarerCommorb(v2)Rubber chickenYo-yo

Emotes with sound | BeckonSkill CapeAir GuitarUri transformRelic unlockTrick