[Music Track: The_Sinclairs]

The Sinclairs(#704)







Released | 24 July2007(Update)

Members | Yes

Location | Camelot

Unlock hint | This track unlocks during the King's Ransom quest.

Quest | King's Ransom

Instruments | Harpsichord, Tubular Bells, French Horn, FX 2 (soundtrack), Percussion

Duration | 01:06

Composer | Adam Bond



The Sinclairsis amusictrack that plays duringKing's Ransom. It can be heard during the cutscene when the player spies on the Sinclairs, revealing thatAnnaandDavidhave betrayed the player.

Changes[edit|edit source]

Date | Changes

27 April2022(update) | The music track is now listed in theMusic Player.

v•t•eKing's Ransom

NPCs | AlanAnnaDavidDonovanGossipHobbesCourt judgeLouisaMaryMerlinMorgan Le FayePierreProsecutorRenegade KnightStanfordWizard CrompertyGuardsSinclair MansionCourthouseKing's RansomKnights of the Round TableKing ArthurSir BedivereSir GawainSir KaySir LancelotSir LucanSir PalomedesSir PelleasSir Tristram |  | AlanAnnaDavidDonovanGossipHobbesCourt judgeLouisaMaryMerlinMorgan Le FayePierreProsecutorRenegade KnightStanfordWizard Cromperty | Guards | Sinclair MansionCourthouseKing's Ransom | Knights of the Round Table | King ArthurSir BedivereSir GawainSir KaySir LancelotSir LucanSir PalomedesSir PelleasSir Tristram

 | AlanAnnaDavidDonovanGossipHobbesCourt judgeLouisaMaryMerlinMorgan Le FayePierreProsecutorRenegade KnightStanfordWizard Cromperty

Guards | Sinclair MansionCourthouseKing's Ransom

Knights of the Round Table | King ArthurSir BedivereSir GawainSir KaySir LancelotSir LucanSir PalomedesSir PelleasSir Tristram

Items | Scrap paperAddress formBlack knight helmHoly grailAnimate rock scrollCriminal's threadHair clip

Rewards | Antique lamp

Locations | Keep Le FayeBlack Knights' FortressSeers' Village Courthouse

Music | KnightmareLore and OrderThe Sinclairs

Related | Quick guideTable (King's Ransom)

v•t•eMusic

Game-related | Music PlayerMusic capeOlaf the Bard

Lists | Music tracks(F2P)Boss musicJinglesRelease datesUnlisted musicUnlock map(Classic•F2P)Sound IDs

Official Soundtracks | RuneScape: Original Soundtrack ClassicsRuneScape: The Orchestral CollectionRuneScape: Song of the ElvesRuneScape: Theatre of BloodRuneScape: DarkmeyerRuneScape: Kebos LowlandsRuneScape: Old School Combat ClassicsOld School RuneScape: Between Two WorldsRuneScape: Battleaxes and BalladsRuneScape: Old School Runebreaks

Musical instruments | BellsChurch organCowbellsCrystal chimeEnchanted lyreOrganPenguin bongosSlayer bellSnake charmWindchimes

Items with sound | BullroarerCommorb(v2)Rubber chickenYo-yo

Emotes with sound | BeckonSkill CapeAir GuitarUri transformRelic unlockTrick