[Music Track: The_Houses_of_Kourend]

The Houses of Kourend(#660)







Released | 16 June2021(Update)

Members | Yes

Location | Xeric's Lookout

Unlock hint | This track unlocks during the A Kingdom Divided quest.

Quest | A Kingdom Divided

Instruments | Pizzicato Strings, Timpani, String Ensemble 1, Percussion

Duration | 02:32

Composer | Grace Docksey



Map



The Houses of Kourendis amusictrack that is unlocked during thequestA Kingdom Divided, in which the five houses ofGreat Kourendare gathered to inform them about the revelations the player has discovered. However, the track plays inXeric's Lookoutbasement only during both cutscenes occurring there, asThe Militiaplays there otherwise.

v•t•eA Kingdom Divided

NPCs | Martin HoltProtesterCommander FulloreTomas LawryCaptain GineaSergeantFuggyCabin Boy HerbertIstoriaProtest LeaderRoseKaht B'alamVeosLizardmanKaal-Mej-SanKaal-Ket-JorKaal-Xil-DarIgnisiaJorraMoriDisciple of YamaPhileas RimorCaptain RachelleLords and LadiesLord Kandur HosidiusLady Shauna PiscariliusLord Shiro ShayzienLord Trobin ArceuusLady Vulcana LovakengjKourend CouncilDavid AndrewsKubec UnkarLiam OrsonSophia Hughes(former)EnemiesJudge of YamaAssassinLizardman BruteXamphur(Phantom Hand)Barbarian WarlordCoronation ceremonyQueen EllamariaKing RoaldDuke HoracioSir Amik VarzeSir Tiffy CashienKing Lathas(Thoros)Asteros ArceuusArtur HosidiusElena HosidiusPandur HosidiusQueen Zyanyi ArkanKualti |  | Martin HoltProtesterCommander FulloreTomas LawryCaptain GineaSergeantFuggyCabin Boy HerbertIstoriaProtest LeaderRoseKaht B'alamVeosLizardmanKaal-Mej-SanKaal-Ket-JorKaal-Xil-DarIgnisiaJorraMoriDisciple of YamaPhileas RimorCaptain Rachelle | Lords and Ladies | Lord Kandur HosidiusLady Shauna PiscariliusLord Shiro ShayzienLord Trobin ArceuusLady Vulcana Lovakengj | Kourend Council | David AndrewsKubec UnkarLiam OrsonSophia Hughes(former) | Enemies | Judge of YamaAssassinLizardman BruteXamphur(Phantom Hand)Barbarian Warlord | Coronation ceremony | Queen EllamariaKing RoaldDuke HoracioSir Amik VarzeSir Tiffy CashienKing Lathas(Thoros)Asteros ArceuusArtur HosidiusElena HosidiusPandur HosidiusQueen Zyanyi ArkanKualti

 | Martin HoltProtesterCommander FulloreTomas LawryCaptain GineaSergeantFuggyCabin Boy HerbertIstoriaProtest LeaderRoseKaht B'alamVeosLizardmanKaal-Mej-SanKaal-Ket-JorKaal-Xil-DarIgnisiaJorraMoriDisciple of YamaPhileas RimorCaptain Rachelle

Lords and Ladies | Lord Kandur HosidiusLady Shauna PiscariliusLord Shiro ShayzienLord Trobin ArceuusLady Vulcana Lovakengj

Kourend Council | David AndrewsKubec UnkarLiam OrsonSophia Hughes(former)

Enemies | Judge of YamaAssassinLizardman BruteXamphur(Phantom Hand)Barbarian Warlord

Coronation ceremony | Queen EllamariaKing RoaldDuke HoracioSir Amik VarzeSir Tiffy CashienKing Lathas(Thoros)Asteros ArceuusArtur HosidiusElena HosidiusPandur HosidiusQueen Zyanyi ArkanKualti

Items | Protest bannerLizardman eggDark nullifierBroken redirectorSulphur potionShielding potionSophia Hughes' investigationBloody knifeBoneCultist robeDelivery confirmationDemonic incantationsKourend mapOrder formReceiptRoseTextsRose's diaryRose's noteTatty noteResearch notesRoyal Accord of TwillShayzien journalDeclarationKeysBluish keyCold keyDamp key |  | Protest bannerLizardman eggDark nullifierBroken redirectorSulphur potionShielding potion | Sophia Hughes' investigation | Bloody knifeBoneCultist robeDelivery confirmationDemonic incantationsKourend mapOrder formReceiptRose | Texts | Rose's diaryRose's noteTatty noteResearch notesRoyal Accord of TwillShayzien journalDeclaration | Keys | Bluish keyCold keyDamp key

 | Protest bannerLizardman eggDark nullifierBroken redirectorSulphur potionShielding potion

Sophia Hughes' investigation | Bloody knifeBoneCultist robeDelivery confirmationDemonic incantationsKourend mapOrder formReceiptRose

Texts | Rose's diaryRose's noteTatty noteResearch notesRoyal Accord of TwillShayzien journalDeclaration

Keys | Bluish keyCold keyDamp key

Rewards | Book of the deadAntique lamp

Locations | Arceuus LibraryBarbarian CampForthos RuinsKebos LowlandsKingstownKourend CastleLizardman TemplePort PiscariliusSettlement RuinsThe Legless FaunXeric's Lookout

Music | ConfrontationJudgement of the DepthsRoseThe Part Where You DieThe Houses of KourendRegal Pomp

Related | Quick guide(speedrunning)Transcript

v•t•eMusic

Game-related | Music PlayerMusic capeOlaf the Bard

Lists | Music tracks(F2P)Boss musicJinglesRelease datesUnlisted musicUnlock map(Classic•F2P)Sound IDs

Official Soundtracks | RuneScape: Original Soundtrack ClassicsRuneScape: The Orchestral CollectionRuneScape: Song of the ElvesRuneScape: Theatre of BloodRuneScape: DarkmeyerRuneScape: Kebos LowlandsRuneScape: Old School Combat ClassicsOld School RuneScape: Between Two WorldsRuneScape: Battleaxes and BalladsRuneScape: Old School Runebreaks

Musical instruments | BellsChurch organCowbellsCrystal chimeEnchanted lyreOrganPenguin bongosSlayer bellSnake charmWindchimes

Items with sound | BullroarerCommorb(v2)Rubber chickenYo-yo

Emotes with sound | BeckonSkill CapeAir GuitarUri transformRelic unlockTrick