[Music Track: The_Maiden%27s_Sorrow]

The Maiden's Sorrow(#574)







Released | 7 June2018(Update)

Members | Yes

Location | Theatre of Blood

Unlock hint | This track unlocks in the Theatre of Blood.

Quest | No

Instruments | Acoustic Grand Piano, Electric Piano 1, Rock Organ, Fretless Bass, Tremolo Strings, Timpani, Choir Aahs, Pad 4 (choir), FX 3 (crystal), Reverse Cymbal, Percussion

Duration | 08:58

Composer | Ian Taylor



Map



The Maiden's Sorrowis amusictrack that is unlocked upon enteringThe Maiden of Sugadinti's room in theTheatre of Blood.

The track can also be heard during the ending cutscene ofA Taste of Hope, however this does not actually unlock the track for the player.

v•t•eMusic

Game-related | Music PlayerMusic capeOlaf the Bard

Lists | Music tracks(F2P)Boss musicJinglesRelease datesUnlisted musicUnlock map(Classic•F2P)Sound IDs

Official Soundtracks | RuneScape: Original Soundtrack ClassicsRuneScape: The Orchestral CollectionRuneScape: Song of the ElvesRuneScape: Theatre of BloodRuneScape: DarkmeyerRuneScape: Kebos LowlandsRuneScape: Old School Combat ClassicsOld School RuneScape: Between Two WorldsRuneScape: Battleaxes and BalladsRuneScape: Old School Runebreaks

Musical instruments | BellsChurch organCowbellsCrystal chimeEnchanted lyreOrganPenguin bongosSlayer bellSnake charmWindchimes

Items with sound | BullroarerCommorb(v2)Rubber chickenYo-yo

Emotes with sound | BeckonSkill CapeAir GuitarUri transformRelic unlockTrick

v•t•eTheatre of Blood

Ver Sinhaza | AbigailaHarpertGarthMercenaryMeiyerditch citizenMysterious StrangerVyreladyVyrelordVyre Orator

NPCs (inside) | NylocasAthanatosHagiosIschyrosMatomenosPrinkipasToxobolosVasiliasBossesThe Maiden of Sugadinti(Blood spawn)Pestilent BloatNylocas VasiliasSotetsegXarpusVerzik Vitur | Nylocas | AthanatosHagiosIschyrosMatomenosPrinkipasToxobolosVasilias | Bosses | The Maiden of Sugadinti(Blood spawn)Pestilent BloatNylocas VasiliasSotetsegXarpusVerzik Vitur

Nylocas | AthanatosHagiosIschyrosMatomenosPrinkipasToxobolosVasilias

Bosses | The Maiden of Sugadinti(Blood spawn)Pestilent BloatNylocas VasiliasSotetsegXarpusVerzik Vitur

Items | BandagesDawnbringerMessageBooksSerafina's diaryThe butcherArachnids of vampyriumThe shadow realmThe wild huntVerzik vitur - patient record |  | BandagesDawnbringerMessage | Books | Serafina's diaryThe butcherArachnids of vampyriumThe shadow realmThe wild huntVerzik vitur - patient record

 | BandagesDawnbringerMessage

Books | Serafina's diaryThe butcherArachnids of vampyriumThe shadow realmThe wild huntVerzik vitur - patient record

Rewards | PotionsVial of bloodBastion potionBattlemage potionWeaponsAvernic defender(hilt)Ghrazi rapierSanguinesti staffScythe of ViturJusticiar armourFaceguardChestguardLegguardsSinhaza shroudTier 1Tier 2Tier 3Tier 4Tier 5OtherLil' zikHard ModeTransforming itemsHoly ornament kitSanguine ornament kitSanguine dustOrnamented weaponsHoly sanguinesti staffHoly ghrazi rapierHoly scythe of viturSanguine scythe of viturPet transmogsLil' MaidenLil' BloatLil' NyloLil' SotLil' Xarp | Potions | Vial of bloodBastion potionBattlemage potion | Weapons | Avernic defender(hilt)Ghrazi rapierSanguinesti staffScythe of Vitur | Justiciar armour | FaceguardChestguardLegguards | Sinhaza shroud | Tier 1Tier 2Tier 3Tier 4Tier 5 | Other | Lil' zik | Hard Mode | Transforming itemsHoly ornament kitSanguine ornament kitSanguine dustOrnamented weaponsHoly sanguinesti staffHoly ghrazi rapierHoly scythe of viturSanguine scythe of viturPet transmogsLil' MaidenLil' BloatLil' NyloLil' SotLil' Xarp | Transforming items | Holy ornament kitSanguine ornament kitSanguine dust | Ornamented weapons | Holy sanguinesti staffHoly ghrazi rapierHoly scythe of viturSanguine scythe of vitur | Pet transmogs | Lil' MaidenLil' BloatLil' NyloLil' SotLil' Xarp

Potions | Vial of bloodBastion potionBattlemage potion

Weapons | Avernic defender(hilt)Ghrazi rapierSanguinesti staffScythe of Vitur

Justiciar armour | FaceguardChestguardLegguards

Sinhaza shroud | Tier 1Tier 2Tier 3Tier 4Tier 5

Other | Lil' zik

Hard Mode | Transforming itemsHoly ornament kitSanguine ornament kitSanguine dustOrnamented weaponsHoly sanguinesti staffHoly ghrazi rapierHoly scythe of viturSanguine scythe of viturPet transmogsLil' MaidenLil' BloatLil' NyloLil' SotLil' Xarp | Transforming items | Holy ornament kitSanguine ornament kitSanguine dust | Ornamented weapons | Holy sanguinesti staffHoly ghrazi rapierHoly scythe of viturSanguine scythe of vitur | Pet transmogs | Lil' MaidenLil' BloatLil' NyloLil' SotLil' Xarp

Transforming items | Holy ornament kitSanguine ornament kitSanguine dust

Ornamented weapons | Holy sanguinesti staffHoly ghrazi rapierHoly scythe of viturSanguine scythe of vitur

Pet transmogs | Lil' MaidenLil' BloatLil' NyloLil' SotLil' Xarp

Scenery | Monumental chestGrand bookshelfOperating tablePortalScoreboardSupporting PillarSupportTeleport crystalWeapon rackChest (supplies)

Music | SoundtrackThe Maiden's SorrowThe Maiden's AngerWelcome to my NightmareThe Nightmare ContinuesDance of the NylocasArachnids of VampyriumThe Dark Beast SotetsegPower of the Shadow RealmPredator XarpusLast King of the YarasaIt's not over 'til...The Fat Lady SingsThe Curtain Closes

Related | A Night at the TheatreRecordsStrategies