[Music Track: The_Enchanter]

The Enchanter(#356)







Released | 4 January2006(Update)

Members | Yes

Location | Mage Training Arena

Unlock hint | This track unlocks in the Enchantment Chamber in the Mage Training Arena.

Quest | No

Instruments | Acoustic Guitar (nylon), Fretless Bass, Pizzicato Strings, Timpani, Choir Aahs, French Horn, Ocarina, Pad 1 (new age), Pad 6 (metallic), FX 4 (atmosphere), Reverse Cymbal, Percussion

Duration | 04:11

Composer | Ian Taylor



Map



The Enchanteris amusictrack that is unlocked in theEnchanting Chamberduring theMage Training Arena.

Versions[edit|edit source]

Version | Release | Music Track

1 | 19 December2005 | 

2 | 6 March2007 | 

v•t•eMusic

Game-related | Music PlayerMusic capeOlaf the Bard

Lists | Music tracks(F2P)Boss musicJinglesRelease datesUnlisted musicUnlock map(Classic•F2P)Sound IDs

Official Soundtracks | RuneScape: Original Soundtrack ClassicsRuneScape: The Orchestral CollectionRuneScape: Song of the ElvesRuneScape: Theatre of BloodRuneScape: DarkmeyerRuneScape: Kebos LowlandsRuneScape: Old School Combat ClassicsOld School RuneScape: Between Two WorldsRuneScape: Battleaxes and BalladsRuneScape: Old School Runebreaks

Musical instruments | BellsChurch organCowbellsCrystal chimeEnchanted lyreOrganPenguin bongosSlayer bellSnake charmWindchimes

Items with sound | BullroarerCommorb(v2)Rubber chickenYo-yo

Emotes with sound | BeckonSkill CapeAir GuitarUri transformRelic unlockTrick

v•t•eMage Training Arena

 | Entrance GuardianRewards GuardianPizazz pointsArena bookProgress hatCharmed Warrior

Telekinetic Theatre | Telekinetic GuardianMaze GuardianTelekinetic GrabGuardian statue

Creature Graveyard | Graveyard GuardianBones to BananasBones to PeachesAnimals' bonesBananaPeach

Enchanting Chamber | Enchantment GuardianLevel 1Level 2Level 3Level 4Level 5Level 6Level 7IcosahedronCubePentamidCylinderOrbDragonstone

Alchemist's Playground | Alchemy GuardianLow Level AlchemyHigh Level AlchemyLeather bootsAdamant kiteshieldAdamant med helmEmeraldRune longswordCoins

Rewards | Infinity robesHatTopBottomsGlovesBootsWandsBeginnerApprenticeTeacherMasterOtherMage's bookBones to PeachesRunesMistDustMudSmokeSteamLavaCosmicChaosNatureDeathLawSoulBlood | Infinity robes | HatTopBottomsGlovesBoots | Wands | BeginnerApprenticeTeacherMaster | Other | Mage's bookBones to Peaches | Runes | MistDustMudSmokeSteamLavaCosmicChaosNatureDeathLawSoulBlood

Infinity robes | HatTopBottomsGlovesBoots

Wands | BeginnerApprenticeTeacherMaster

Other | Mage's bookBones to Peaches

Runes | MistDustMudSmokeSteamLavaCosmicChaosNatureDeathLawSoulBlood

Music tracks | Golden TouchMind over MatterRoll the BonesShineThe Enchanter