[Music Track: The_Spurned_Demon_(music_track)]

The Spurned Demon(#618)







Released | 25 July2019(Update)

Members | Yes

Location | Prifddinas

Unlock hint | This track unlocks while fighting Zalcano.

Quest | No

Instruments | Bright Acoustic Piano, Tubular Bells, Orchestral Harp, String Ensemble 1, Brass Section, FX 3 (crystal), Percussion, Custom Choir

Duration | 07:17

Composer | Julian Surma



Map



The Spurned Demonis amusictrack that is unlocked while fightingZalcanoinPrifddinas.

v•t•eZalcano

NPCs | GolemRhiannonZalcano

Items | TephraRefined tephraImbued tephra

Notable drops | Crystal shardCrystal tool seedZalcano shardSmolcano

Scenery | AltarBarrierDemonic SymbolFurnaceRock FormationTeleport Platform

Related | The Spurned DemonThe spurned demon

v•t•ePrifddinas

Inhabitants | AlwynBankerBrynCrabConwennaCrefyddElenaElunedElven city guard(removed)Friendly ForesterGuardGatekeeper guardIlfeenMorvranOswalltPennantRavenReeseRhiannonTool LeprechaunYstwythClan leadersLord Ieuan AmloddLord Baxtorian CadarnLord Piquan CrwysLady Carys HefinLord Iestin IorwerthLady Kelyn IthellLady Ffion MeilyrLady Tangwen TrahaearnShop ownersAneirinAnwenBranwenCaerwynCelynDerwenEfaEiraElganGlendaGuinevereGwallterGwynIslwynIwanLliannLlioNiaOsianSawmill OperatorSianPickpocketableAnaireAranweAredhelCaranthirCelebrianCelegormCirdanCurufinEarwenEdrahilElenweElladanEnelErestorEnerdhilEnelyeFeanorFindisFinduilasFingolfinFingonGalathilGelmirGlorfindelGuilinHendorIdrilIminIminyeIndisIngweIngwionLenweLindirMaeglinMahtanMirielMithrellasNellasNerdanelNimlothOropherOrophinSaerosSalgantTatieThingolTurgonVaireGrand LibraryEldaloteFinarfinGwindorLilifangMaedhrosNimrodelGladiator ringCleddyfDiolEnillyFfoniGladiatorGwylRhyfelSadwrnSaethYmladdYsbeidSurrounding areasBear CubEdGhostGwerin HapusIan(removed)LennyLleidr GolauMarwolaeth DawnsioMeddwl Ymlaen LlawPreswylwyr DallRabbitRhoddwr TanRed PandaSurmaSlippersTideTrader Crewmember |  | AlwynBankerBrynCrabConwennaCrefyddElenaElunedElven city guard(removed)Friendly ForesterGuardGatekeeper guardIlfeenMorvranOswalltPennantRavenReeseRhiannonTool LeprechaunYstwyth | Clan leaders | Lord Ieuan AmloddLord Baxtorian CadarnLord Piquan CrwysLady Carys HefinLord Iestin IorwerthLady Kelyn IthellLady Ffion MeilyrLady Tangwen Trahaearn | Shop owners | AneirinAnwenBranwenCaerwynCelynDerwenEfaEiraElganGlendaGuinevereGwallterGwynIslwynIwanLliannLlioNiaOsianSawmill OperatorSian | Pickpocketable | AnaireAranweAredhelCaranthirCelebrianCelegormCirdanCurufinEarwenEdrahilElenweElladanEnelErestorEnerdhilEnelyeFeanorFindisFinduilasFingolfinFingonGalathilGelmirGlorfindelGuilinHendorIdrilIminIminyeIndisIngweIngwionLenweLindirMaeglinMahtanMirielMithrellasNellasNerdanelNimlothOropherOrophinSaerosSalgantTatieThingolTurgonVaire | Grand Library | EldaloteFinarfinGwindorLilifangMaedhrosNimrodel | Gladiator ring | CleddyfDiolEnillyFfoniGladiatorGwylRhyfelSadwrnSaethYmladdYsbeid | Surrounding areas | Bear CubEdGhostGwerin HapusIan(removed)LennyLleidr GolauMarwolaeth DawnsioMeddwl Ymlaen LlawPreswylwyr DallRabbitRhoddwr TanRed PandaSurmaSlippersTideTrader Crewmember

 | AlwynBankerBrynCrabConwennaCrefyddElenaElunedElven city guard(removed)Friendly ForesterGuardGatekeeper guardIlfeenMorvranOswalltPennantRavenReeseRhiannonTool LeprechaunYstwyth

Clan leaders | Lord Ieuan AmloddLord Baxtorian CadarnLord Piquan CrwysLady Carys HefinLord Iestin IorwerthLady Kelyn IthellLady Ffion MeilyrLady Tangwen Trahaearn

Shop owners | AneirinAnwenBranwenCaerwynCelynDerwenEfaEiraElganGlendaGuinevereGwallterGwynIslwynIwanLliannLlioNiaOsianSawmill OperatorSian

Pickpocketable | AnaireAranweAredhelCaranthirCelebrianCelegormCirdanCurufinEarwenEdrahilElenweElladanEnelErestorEnerdhilEnelyeFeanorFindisFinduilasFingolfinFingonGalathilGelmirGlorfindelGuilinHendorIdrilIminIminyeIndisIngweIngwionLenweLindirMaeglinMahtanMirielMithrellasNellasNerdanelNimlothOropherOrophinSaerosSalgantTatieThingolTurgonVaire

Grand Library | EldaloteFinarfinGwindorLilifangMaedhrosNimrodel

Gladiator ring | CleddyfDiolEnillyFfoniGladiatorGwylRhyfelSadwrnSaethYmladdYsbeid

Surrounding areas | Bear CubEdGhostGwerin HapusIan(removed)LennyLleidr GolauMarwolaeth DawnsioMeddwl Ymlaen LlawPreswylwyr DallRabbitRhoddwr TanRed PandaSurmaSlippersTideTrader Crewmember

Clans | AmloddCadarnCrwysHefinIorwerthIthellMeilyrTrahaearn

Shops | Amlodd's Magical SuppliesAneirin's ArmourBranwen's Farming ShopConstruction suppliesElgan's Exceptional Staffs!Guinevere's DyesGwyn's Mining EmporiumHefin InnIorwerth's ArmsIwan's MacesLliann's WaresPrifddinas FoodstuffsPrifddinas Gem StallPrifddinas General StorePrifddinas Herbal SuppliesPrifddinas Silver StallPrifddinas Spice StallPrifddinas' SeamstressSian's Ranged Weaponry

Features | The GauntletZalcanoIorwerth DungeonPrifddinas Agility CourseCrystal tree patchElven Crystal ChestHouse portalTrahaearn mineTeleport PlatformNorth bankSouth bank

Music | Architects of PrifddinasDance of the MeilyrElven GuardiansFaith of the HefinThe GauntletIorwerth's LamentMystics of NatureThe Seed of CrwysSharp End of the CrystalThe Spurned DemonThe Tower of VoicesTrahaearn Toil

Related | Memoriam DeviceGorlahGwenithElven rabbit caveMynyddTirannwn

v•t•eMusic

Game-related | Music PlayerMusic capeOlaf the Bard

Lists | Music tracks(F2P)Boss musicJinglesRelease datesUnlisted musicUnlock map(Classic•F2P)Sound IDs

Official Soundtracks | RuneScape: Original Soundtrack ClassicsRuneScape: The Orchestral CollectionRuneScape: Song of the ElvesRuneScape: Theatre of BloodRuneScape: DarkmeyerRuneScape: Kebos LowlandsRuneScape: Old School Combat ClassicsOld School RuneScape: Between Two WorldsRuneScape: Battleaxes and BalladsRuneScape: Old School Runebreaks

Musical instruments | BellsChurch organCowbellsCrystal chimeEnchanted lyreOrganPenguin bongosSlayer bellSnake charmWindchimes

Items with sound | BullroarerCommorb(v2)Rubber chickenYo-yo

Emotes with sound | BeckonSkill CapeAir GuitarUri transformRelic unlockTrick