[Music Track: The_Far_Side]

The Far Side(#308)







Released | 22 June2005(Update)

Members | Yes

Location | Rogues' Den

Unlock hint | This track unlocks in the Rogues' Den minigame.

Quest | No

Instruments | Marimba, Tubular Bells, Pizzicato Strings, String Ensemble 1, String Ensemble 2, Choir Aahs, Trumpet, French Horn, Brass Section, Bassoon, Flute, Percussion

Duration | 03:55

Composer | Ian Taylor



Map



The Far Sideis amusictrack that is unlocked atRogues' Den. It is unlocked by traversing far enough through the maze minigame.

Versions[edit|edit source]

Version | Release | Music Track

1 | 18 April2005 | 

2 | 6 March2007 | 

v•t•eMusic

Game-related | Music PlayerMusic capeOlaf the Bard

Lists | Music tracks(F2P)Boss musicJinglesRelease datesUnlisted musicUnlock map(Classic•F2P)Sound IDs

Official Soundtracks | RuneScape: Original Soundtrack ClassicsRuneScape: The Orchestral CollectionRuneScape: Song of the ElvesRuneScape: Theatre of BloodRuneScape: DarkmeyerRuneScape: Kebos LowlandsRuneScape: Old School Combat ClassicsOld School RuneScape: Between Two WorldsRuneScape: Battleaxes and BalladsRuneScape: Old School Runebreaks

Musical instruments | BellsChurch organCowbellsCrystal chimeEnchanted lyreOrganPenguin bongosSlayer bellSnake charmWindchimes

Items with sound | BullroarerCommorb(v2)Rubber chickenYo-yo

Emotes with sound | BeckonSkill CapeAir GuitarUri transformRelic unlockTrick

v•t•eRogues' Den

NPCs | Brian O'RichardEmerald BenedictGraceMarkMartin ThwaitRogue Guard

Items | Flash powderMystic jewelTilesStethoscope

Rewards | Rogue equipmentMaskTopTrousersGlovesBootsOtherRogue's equipment crateRogue kit | Rogue equipment | MaskTopTrousersGlovesBoots | Other | Rogue's equipment crateRogue kit

Rogue equipment | MaskTopTrousersGlovesBoots

Other | Rogue's equipment crateRogue kit

Scenery | Obstacles and trapsDoorwayContortion BarsPendulumSpinning bladesBladeWallFloorLedgeGrillSpin Blades(unused)PassagewayOtherWall safe(lobby)Door(lobby•shortcut•viewing gallery)LadderCorpseTrapdoorChest | Obstacles and traps | DoorwayContortion BarsPendulumSpinning bladesBladeWallFloorLedgeGrillSpin Blades(unused)Passageway | Other | Wall safe(lobby)Door(lobby•shortcut•viewing gallery)LadderCorpseTrapdoorChest

Obstacles and traps | DoorwayContortion BarsPendulumSpinning bladesBladeWallFloorLedgeGrillSpin Blades(unused)Passageway

Other | Wall safe(lobby)Door(lobby•shortcut•viewing gallery)LadderCorpseTrapdoorChest

Stores | Martin Thwait's Lost and Found.Grace's Graceful Clothing

Music | The Far SideThe Rogues' Den