[Music Track: The_Bane_of_Ashihama]

The Bane of Ashihama(#627)







Released | 6 February2020(Update)

Members | Yes

Location | The Nightmare

Unlock hint | This track unlocks while fighting the Nightmare.

Quest | No

Instruments | Acoustic Grand Piano, Bright Acoustic Piano, Celesta, Tubular Bells, String Ensemble 1, Orchestra Hit, Brass Section, FX 3 (crystal), Percussion, Custom Choir

Duration | 05:39

Composer | Julian Surma



Map



The Bane of Ashihamais amusictrack that is unlocked during the fight withThe Nightmare. It can be also be unlocked by spectating an ongoing fight.

v•t•eThe Nightmare

Monsters | The NightmareHuskParasiteSleepwalkerPhosani's NightmarePhosani's NightmareHuskParasiteSleepwalker |  | The NightmareHuskParasiteSleepwalker | Phosani's Nightmare | Phosani's NightmareHuskParasiteSleepwalker

 | The NightmareHuskParasiteSleepwalker

Phosani's Nightmare | Phosani's NightmareHuskParasiteSleepwalker

Signature drops | Nightmare staffStandardEldritchHarmonisedVolatileOrbsEldritchHarmonisedVolatileInquisitor's equipmentMaceGreat helmHauberkPlateskirtPetLittle nightmareParasitic eggMiscellaneousJar of dreamsSlepey tablet | Nightmare staff | StandardEldritchHarmonisedVolatile | Orbs | EldritchHarmonisedVolatile | Inquisitor's equipment | MaceGreat helmHauberkPlateskirt | Pet | Little nightmareParasitic egg | Miscellaneous | Jar of dreamsSlepey tablet

Nightmare staff | StandardEldritchHarmonisedVolatile

Orbs | EldritchHarmonisedVolatile

Inquisitor's equipment | MaceGreat helmHauberkPlateskirt

Pet | Little nightmareParasitic egg

Miscellaneous | Jar of dreamsSlepey tablet

Scenery | Scoreboard(Phosani's)Pool of Nightmares(Historical)Totem(Phosani's)Nightmare BerriesNightmare BlossomSpore

Music | The Bane of AshihamaThe Everlasting Slumber

Other | ShuraSister SengaSiren's tomeSisterhood Sanctuary

v•t•eMusic

Game-related | Music PlayerMusic capeOlaf the Bard

Lists | Music tracks(F2P)Boss musicJinglesRelease datesUnlisted musicUnlock map(Classic•F2P)Sound IDs

Official Soundtracks | RuneScape: Original Soundtrack ClassicsRuneScape: The Orchestral CollectionRuneScape: Song of the ElvesRuneScape: Theatre of BloodRuneScape: DarkmeyerRuneScape: Kebos LowlandsRuneScape: Old School Combat ClassicsOld School RuneScape: Between Two WorldsRuneScape: Battleaxes and BalladsRuneScape: Old School Runebreaks

Musical instruments | BellsChurch organCowbellsCrystal chimeEnchanted lyreOrganPenguin bongosSlayer bellSnake charmWindchimes

Items with sound | BullroarerCommorb(v2)Rubber chickenYo-yo

Emotes with sound | BeckonSkill CapeAir GuitarUri transformRelic unlockTrick