[Music Track: Time_to_Mine]

Time to Mine(#277)







Released | 21 March2005(Update)

Members | Yes

Location | Keldagrim south-west mine

Unlock hint | This track unlocks during the Between a Rock quest.

Quest | No

Instruments | Celesta, Marimba, Fretless Bass, Trumpet, Alto Sax, Baritone Sax, Oboe, Ocarina, Pad 1 (new age), Pad 7 (halo), FX 7 (echoes), Taiko Drum, Melodic Tom, Custom Percussion

Duration | 04:47

Composer | Ian Taylor



Map



Time to Mineis amusictrack that is unlocked in theKeldagrim south-west mine.

Versions[edit|edit source]

Version | Release | Music Track

1 | 26 January2005 | 

2 | 6 March2007 | 

v•t•eMusic

Game-related | Music PlayerMusic capeOlaf the Bard

Lists | Music tracks(F2P)Boss musicJinglesRelease datesUnlisted musicUnlock map(Classic•F2P)Sound IDs

Official Soundtracks | RuneScape: Original Soundtrack ClassicsRuneScape: The Orchestral CollectionRuneScape: Song of the ElvesRuneScape: Theatre of BloodRuneScape: DarkmeyerRuneScape: Kebos LowlandsRuneScape: Old School Combat ClassicsOld School RuneScape: Between Two WorldsRuneScape: Battleaxes and BalladsRuneScape: Old School Runebreaks

Musical instruments | BellsChurch organCowbellsCrystal chimeEnchanted lyreOrganPenguin bongosSlayer bellSnake charmWindchimes

Items with sound | BullroarerCommorb(v2)Rubber chickenYo-yo

Emotes with sound | BeckonSkill CapeAir GuitarUri transformRelic unlockTrick

v•t•eBetween a Rock...

NPCs | DondakanDwarven EngineerRoladKhorvakArzinian BeingsBordanzanMagicRangingStrength |  | DondakanDwarven EngineerRoladKhorvak | Arzinian Beings | BordanzanMagicRangingStrength

 | DondakanDwarven EngineerRoladKhorvak

Arzinian Beings | BordanzanMagicRangingStrength

Items | Cannon ballGold helmetBooks and PagesDwarven lorePage 1Page 2Page 3PagesSchematicsBaseDondakanDwarven EngineerKhorvakComplete |  | Cannon ballGold helmet | Books and Pages | Dwarven lorePage 1Page 2Page 3Pages | Schematics | BaseDondakanDwarven EngineerKhorvakComplete

 | Cannon ballGold helmet

Books and Pages | Dwarven lorePage 1Page 2Page 3Pages

Schematics | BaseDondakanDwarven EngineerKhorvakComplete

Locations | Dondakan's mineKeldagrimBordanzan

Music | ClaustrophobiaIn BetweenTime to Mine

Related | Quick guide

v•t•eThe Giant Dwarf

NPCs | Dwarven BoatmanVermundiSantiriThurgoReldoSaroDromundDromund's catLibrarianBlack GuardCommander VeldabanSupreme CommanderSculptor's shopBlasidarRikiMining DirectorsBlue OpalBrown EngineGreen GemstonePurple PewterRed AxeSilver CogWhite ChiselYellow FortuneMining SecretariesBlue OpalBrown EngineGreen GemstonePurple PewterRed AxeSilver CogWhite ChiselYellow Fortune |  | Dwarven BoatmanVermundiSantiriThurgoReldoSaroDromundDromund's catLibrarian | Black Guard | Commander VeldabanSupreme Commander | Sculptor's shop | BlasidarRiki | Mining Directors | Blue OpalBrown EngineGreen GemstonePurple PewterRed AxeSilver CogWhite ChiselYellow Fortune | Mining Secretaries | Blue OpalBrown EngineGreen GemstonePurple PewterRed AxeSilver CogWhite ChiselYellow Fortune

 | Dwarven BoatmanVermundiSantiriThurgoReldoSaroDromundDromund's catLibrarian

Black Guard | Commander VeldabanSupreme Commander

Sculptor's shop | BlasidarRiki

Mining Directors | Blue OpalBrown EngineGreen GemstonePurple PewterRed AxeSilver CogWhite ChiselYellow Fortune

Mining Secretaries | Blue OpalBrown EngineGreen GemstonePurple PewterRed AxeSilver CogWhite ChiselYellow Fortune

Items | Book on costumesDwarven battleaxeExquisite clothesLeft bootRight bootExquisite bootsMeeting notes

Locations | Keldagrim

Music | Tale of KeldagrimTime to MineLand of the Dwarves

Miscellaneous | Quick guideTranscriptGiant Dwarf (statue)