[Music Track: Zombie_Invasion]

Zombie Invasion(#759)







Released | 21 February2024(Update)

Members | Yes

Location | Varrock Palace

Unlock hint | This track unlocks during the Defender of Varrock quest.

Quest | Defender of Varrock

Instruments | ?

Duration | 05:08

Composer | Chris Jolley



Zombie Invasionis amusictrack that is unlocked during theDefender of Varrockquest, upon enteringVarrock PalaceduringZemouregal's invasion of the city. The track will also play in place ofother Varrock tracksuntil the invasion is over.

v•t•eDefender of Varrock

NPCs | Elias WhiteCaptain RovinRamarnoReldoKing RoaldDescendant candidatesAeonisig RaispherSir PrysinCurator Haig HalenRomeoHorvikDimintheisAntagonistsSharathteerkZemouregalArravArmoured zombie (Zemouregal's Base)Armoured zombie (Defender of Varrock) |  | Elias WhiteCaptain RovinRamarnoReldoKing Roald | Descendant candidates | Aeonisig RaispherSir PrysinCurator Haig HalenRomeoHorvikDimintheis | Antagonists | SharathteerkZemouregalArravArmoured zombie (Zemouregal's Base)Armoured zombie (Defender of Varrock)

 | Elias WhiteCaptain RovinRamarnoReldoKing Roald

Descendant candidates | Aeonisig RaispherSir PrysinCurator Haig HalenRomeoHorvikDimintheis

Antagonists | SharathteerkZemouregalArravArmoured zombie (Zemouregal's Base)Armoured zombie (Defender of Varrock)

Items | Grubby keyBottleBottle of mistImbued barroniteShield of ArravList of elders

Scenery | Zombie trackingPlantTree stumpBushRocksWilderness SignTrapdoorZemouregal's baseLadderBalconyRed mistGateDoorBookVarrock castleSuit of armourShieldStatue of a kingSword cabinetChairBroken chairChurch pewStoolDesk | Zombie tracking | PlantTree stumpBushRocksWilderness SignTrapdoor | Zemouregal's base | LadderBalconyRed mistGateDoorBook | Varrock castle | Suit of armourShieldStatue of a kingSword cabinetChairBroken chairChurch pewStoolDesk

Zombie tracking | PlantTree stumpBushRocksWilderness SignTrapdoor

Zemouregal's base | LadderBalconyRed mistGateDoorBook

Varrock castle | Suit of armourShieldStatue of a kingSword cabinetChairBroken chairChurch pewStoolDesk

Music | Undead ArmyThe Dream TheatreZombie Invasion

Related | Quick guideTranscriptElias whiteZemouregal's BaseVarrock CensusSacred Forge

v•t•eMusic

Game-related | Music PlayerMusic capeOlaf the Bard

Lists | Music tracks(F2P)Boss musicJinglesRelease datesUnlisted musicUnlock map(Classic•F2P)Sound IDs

Official Soundtracks | RuneScape: Original Soundtrack ClassicsRuneScape: The Orchestral CollectionRuneScape: Song of the ElvesRuneScape: Theatre of BloodRuneScape: DarkmeyerRuneScape: Kebos LowlandsRuneScape: Old School Combat ClassicsOld School RuneScape: Between Two WorldsRuneScape: Battleaxes and BalladsRuneScape: Old School Runebreaks

Musical instruments | BellsChurch organCowbellsCrystal chimeEnchanted lyreOrganPenguin bongosSlayer bellSnake charmWindchimes

Items with sound | BullroarerCommorb(v2)Rubber chickenYo-yo

Emotes with sound | BeckonSkill CapeAir GuitarUri transformRelic unlockTrick